Brand,Domain,1-3,4-10,11-100,Total Keywords,Organic Traffic
Alvalaval,www.alfalaval.us,673,774,5419,6866,8934
AMI,appliedmembranes.com,333,1070,7741,9144,6971
Aqualitec,http://www.aqualitec.com/,26,19,178,223,327
AquaTech,https://www.aquatech.com/,146,83,1089,1318,4343
Burt Process Equipment,burtprocess.com,183,581,6050,6814,7283
Chem World,www.chemworld.com,236,831,6250,7317,3881
ChemREADY,https://www.getchemready.com/,108,256,2293,2657,4627
Chemtrac,https://chemtrac.com/,24,48,552,624,328
ChemTreat,www.chemtreat.com,140,184,1776,2100,4367
COMO Filtration,https://www.comofiltration.com/,15,52,586,653,272
Culligan Water,www.culligan.com,4739,5158,36231,46128,146239
Ecologix,www.ecologixsystems.com,220,338,4090,4648,10517
Ellis Corporation,www.elliscorp.com/,47,35,577,659,365
ESP Water Products,www.espwaterproducts.com,2933,4784,23651,31368,69667
EVOQUA,www.evoqua.com/,774,1202,15327,17303,26393
Filtation Systems,www.filtrationsystems.com,19,35,359,413,492
Fluence Corporation,www.fluencecorp.com/,206,460,5560,6226,19459
Highland Tank,www.highlandtank.com,246,460,4771,5477,3956
Hubbell Water Heaters,hubbellheaters.com,122,130,3625,3877,1079
InterCounty Supply,www.icsny.com,2263,5200,23321,30784,84787
IWWS,iwwsllc.com/,1,3,56,60,7
KEMCO,www.kemcosystems.com/,37,42,854,933,603
McLanahan,https://www.mclanahan.com/,311,411,2804,3526,17147
Miura,miuraboiler.com,208,349,3924,4481,4976
Monroe Environmental,www.monroeenvironmental.com,73,142,1152,1367,1316
MWI Pumps,https://mwipumps.com/,153,280,3030,3463,3101
NIJHUIS,www.nijhuisindustries.com/,15,32,360,407,1078
Norchem Industries,www.norchemindustries.com/,1,6,19,26,32
Oil Water Separator Technologies,http://www.owstech.com/,2,21,246,269,213
Pariser Industries,pariser.net,27,23,477,527,241
Pure Aqua,pureaqua.com,768,1934,12876,15578,28604
Puretec,puretecwater.com,470,478,5859,6807,36515
Samco,www.samcotech.com,271,441,3934,4646,7837
Spirax Sarco,www.spiraxsarco.com,1036,1304,16288,18628,66987
Stack,stackheating.com,204,584,6783,7571,3621
Suez Water Technologies & Solutions,www.suezwatertechnologies.com,681,1384,19280,21345,36468
Thermal Engineering of Arizona,www.teatucson.com/,6,3,37,46,56
UniMac,unimac.com,459,447,4106,5012,9213
WESTECH,www.westech-inc.com/,188,228,3043,3459,2508
World Water Works,www.worldwaterworks.com/,16,55,443,514,646